#######
#     #
#h  Le#
#     #
#######
