#######
#   # #
# HKLE#
#   # #
#######
