#######
#   # #
#gHKLE#
#   # #
#######
