#######
# gs  #
#hs de#
#     #
#######
