#######
#     #
#h   e#
#     #
#######
