#######
#     #
# H  E#
#     #
#######
