#####
# E #
#   #
# V #
#   #
#####
