#######
#     #
# H E #
#     #
### V #
  #   #
  #####
