#####
#   ####
# H V E#
#   ####
#####
