#####
#   #
# V #
#   #
##H##
 # #
 #E#
 ###
