#######
#   E #
#     #
# H   #
#   V #
#     #
#######
