#######
#  V  #
#E    #
#    H#
#     #
#######
