########
#C   CC#
# HC E #
#      #
#CCC####
#####
