########
#C  V C#
#    E #
#H C   #
#C  C  #
########
