#####
# E ##
# CC ##
# C  H#
##  C #
 ##V  #
  #####
