#####
# E #
#   #
# G #
#   #
#  V#
#####
