  #####
###E  #
#    H#
# G   #
#  ####
#V #
####
