 #######
##   H #
#  V   #
#  #####
#G   E#
#######
