#####
#V E#
# CC#
#HG #
#   #
#  ##
####
