 ######
##    ###
#HK   LE#
##    ###
 ######
