 #####
 #E  #
 #   #
 #   #
###L###
#V   G#
#     #
#  H  #
#    K#
#######
