  ######
  #    #
  #   E#
####D###
#     #
#H  S #
#    V#
#######
