#########
#C      #
#      E#
#  ######
#  D  CS#
#### V###
 # H    #
 #S    G#
 ########
