############
#    #    ###
# SVHD G  LE#
#    #    ###
# # ## ####
#   # K #
# C   S #
#   #   #
#########
